NO textures/xpm/abadie/abadie_N.xpm
SO textures/xpm/abadie/abadie_S.xpm
WE textures/xpm/abadie/abadie_W.xpm
EA textures/xpm/abadie/abadie_E.xpm

F 71,24,19
C 62,64,71

1111111111111111111111111111
1000011111100001000010000001
1000000000000001000010000001
1000011101100001000010000001
1111111101111111111111110111
1000000100000000000000000001
1000000100111111111111111111
1000000100100000001000000001
1000000100100000001000000001
1110011100100000001000000001
1000000000000000001000000001
1011111111111111111111001111
10000000000000000000000000W1
1111111111111111111111111111