NO textures/simonkraft/wet_sponge.xpm
SO textures/simonkraft/wet_sponge.xpm
WE textures/simonkraft/wet_sponge.xpm
EA textures/simonkraft/wet_sponge.xpm

F 164,169,20
C 153,204,255

1111111     1111111             1111111111111111
1000001     1000001             1000000000000001
1000001     1000001             1011111111000001
1000001     1000001            1001      1000001
1000001     1000001           1001       1111111
1110111111111110111           101
 1100000000000001      1111111101
 1111111001111111      1000000001
       1001            1011111101
       1001111111111111101    101111111111
       1000000000000000001    100000000001
       1001111111111111111    111111000001
       1001                        1000001
       1001111111111111            1111111
       10000000000000W1
       1111111111111111