NO textures/xpm/castle/castle_N.xpm
SO textures/xpm/castle/castle_S.xpm
WE textures/xpm/castle/castle_W.xpm
EA textures/xpm/castle/castle_E.xpm

F 70,70,70
C 180,180,180

 1111111111
110000000011
10000S000001
100000000111
1000000011              111111111111111
111000011             11100000000000011
  100001          111110000000000000001
  100011        111000000001111100000011
   100011       11000000000111 1110000001
    100011      1100000110000111 110000001
    11000111  1110000001100000111000000011
     110000111100001100000000000000011111
	   1100000000000000000000000000011
		11100111110000000000000011111
		  1001   1100001110000011
          1101111100000111000111
		   1000000000000000011
		    110011110111111111
			 1111  111