NO textures/xpm/cavern/cavern_N.xpm
SO textures/xpm/cavern/cavern_S.xpm
WE textures/xpm/cavern/cavern_W.xpm
EA textures/xpm/cavern/cavern_E.xpm

F 82,75,36
C 50,60,57

 1111111111
110000000011
10000S000001
100000000111
1000000011              111111111111111
111000011             11100000000000011
  100001          111110000000000000001
  100011        1110000000011111000000111
   100011       11000000000111 1110000001
    100011      110000011000011 110000001
    11000111  1110000001100000111000000011
     110000111100001100000000000000011111
	   11000000000000000000000000000111
		  11100111110000000000000011111
        11011111000001100001111
         1111111111111111111
