NO textures/xpm/castle/castle_N.xpm
SO textures/xpm/castle/castle_S.xpm
WE textures/xpm/castle/castle_W.xpm
EA textures/xpm/castle/castle_E.xpm

F 70,70,70
C 180,180,180

     111111111111111111
    1000000010000000001
 1111000000010001111101
10000000000010001111101
10001000000011101111101
1000100000001 100000101
10001011111111111000101
10000000000000000000101
 1111111111111111000101
1S1000001       1000001
101000001       1111101
101000001       1111101
101000001       1111101
101000001       1000001
101000001       1011111
101000001       1000001
10111110111111111000001
10100000100000001000001
10100000101111101000001
10100000001000001000001
10100000111000101111011
10000000111000100000001
 111111111111111111111